NO ./path_to_the_north_texture
SO ./path_to_the_south_texture
WE ./path_to_the_west_texture
EA ./path_to_the_east_texture
F 220,10,0
C 225,30,0
1111111111111111111111111
1000000000110000000000001
1011000001110000000000001
100100000000000000000000111111111
111111111011000001110000000000001111
100000000011000001110111111111111
11110111111111000000000010001
111101111 1111011101010010001
11111111111111111111111111111
110000001101010111000000100001
10000000000000001100000010001
10000000S00000000001010010001
110000011101010101110111100001
11110111 10101011011110100011
11111111 11111111111111111111
