NO ./path_to_the_north_texture
SO ./path_to_the_south_texture
WE ./path_to_the_west_texture
EA ./path_to_the_east_texture
F 220,10,0
C 225,30,0
                                111111 
                                110011
                                100001
                                110011
                                100001
                                110011
                                100001
                                110011
                                100001
                                110011
                                100001
                                110011
                                100001
                                110011
                                100001
                                110011
                                100001
111111111111111111111111111111111000011111111111111111111111111111111111111111111111
100101010101010101010101010101010100010101010101010101010101010101010101010101010101
1000000000000000000000000000000000E0000000000000000000000000000000000000000000000001
100010101010101010101010101010101000101010101010101010101010101010101010101010101011
111111111111111111111111111111111000011111111111111111111111111111111111111111111111
                                110011
                                 100001
                                  110011
                                   100001
                                    110011
                                     100001
                                      110011
                                       100001
                                        110011
                                         100001
                                          110011
                                           100001
                                            110011
                                             100001
                                              110011
                                               100001
                                                110011
                                                 100001
                                                  110011
                                                   100001
                                                    111111